oei	oops
sowieso	anyway
och	oh
tweehonderd	two hundred
ha	ah
tweeduizend	two thousand
enfin	in short, anyway
hm	hmm
nul	zero
verbinding	connection
aha	aha
hoezo	why
heleboel	a lot
enzovoort, enz., en zo	etc., and so on
tja	well
frank	frank
amai	~ oh my (God)
alhoewel	although
voilà	there you are
gelijk	just as
pff	whew
Engels	English
tof	great
vierentwintig	twenty-four
bah	yuck
Frans	French
vijfhonderd	five hundred
driehonderd	three hundred
komma	comma
benieuwd	curious
ho	stop
jee	oh dear, oh no
hoi	hi
lesgeven	to teach
zesentwintig	twenty-six
rap	fast, quick(ly)
eenentwintig	twenty-one
tweeëntwintig	twenty-two
cd	CD
drieëntwintig	twenty-three
zat	plenty
vijfendertig	thirty-five
vierhonderd	four hundred
tussendoor	in between
ginder	over there
diegene	he, she, those who
achtentwintig	twenty-eight
dinges	what-d’you-call-it, thingy
vijfenveertig	forty-five
volgend	next
zeshonderd	six hundred
morgenavond	tomorrow
gelukken	to succeed
mailen	to mail, to post
irritant	irritating
opsturen	to send
weeral	again
content	content
wiskunde	mathematics
goesting	fancy
dialect	dialect
groet	greeting
September	September
link	link
bron	source
oppervlakte	surface
forum	forum
topic	topic
indien	if
aangezien	since
post	post
verenigen (zich)	to unite
tevens	also
maja	but then
et cetera, etc.	etc.
statistiek	statistics
afbeelding	image
voornamelijk	mainly
commercieel	commercial
term	term
wereldoorlog	world war
hierdoor	because of this, through this
hierbij	hereby, with this
hiervan	of this
district	district
merk	brand
pink	little finger
deelstaat	(federal) state
westen	west
sterkte	strength
album	album
motorfiets	motorcycle
derde	third
oosten	east
super	super
koninkrijk	kingdom
huishouden	household
zalig	glorious, heavenly
innen	to collect
btw	VAT
haha	haha
republiek	republic
oorsprong	origin
stichten	to found, to start
definitie	definition
luisteraar	listener
kenmerk	characteristic
rijk	state (kingdom, empire)
beschrijving	description
cc	cc
o.a.	amongst other things
onafhankelijkheid	independence
zever	nonsense
departement	department
single	single
geografie	geography
radiostation	radio station
godsdienst	religion
hierin	in this
grenzen	to border
zwangerschap	pregnancy
beluisteren	to listen
dr.	Dr, doctor
hierboven	above
kenmerken	to characterize
hit	hit
keizer	emperor
hierop	(up)on this
geografisch	geographic(al)
paus	pope
indeling	division
Romeins	Roman
frequentie	frequency
zot	foolish
bijgevolg	as a consequence
hoofdzakelijk	mainly
benaming	name
ex	ex
posten	to post
hierna	after this
hieronder	below
verwant	related
vernoemen	to name
privé	private
bevalling	delivery
aanhalen	to pull in, to tighten
splitsen	to split
gewoonweg	simply
downloaden	to download
insect	insect
typen	to type
derhalve	therefore
definiëren	to define
weergeven	to represent
ideologie	ideology
christendom	Christianity
kolonie	colony
interpreteren	to interpret
data	data
nazi	Nazi
gen	gene
hernemen	to resume
historie	history
hieraan	to this
minder	less
verder	further
anders	otherwise
echter	however
meest	most
best	best
vanuit	from
immers	indeed
vrijdag	Friday
organisatie	organization
overheid	government
maandag	Monday
positief	positive
behoren	to belong
intussen	meanwhile
raad	advice
uitvoeren	to perform
niveau	level
woensdag	Wednesday
gratis	free
bedoelen	to intend
liefst	preferably
beperken	to limit
treden	to step
jou	you
donderdag	Thursday
bevestigen	to confirm
weigeren	to refuse
dertig	thirty
discussie	discussion
dinsdag	Tuesday
uitspraak	statement
druk	pressure
veroorzaken	to cause
klant	customer
systeem	system
ontwikkeling	development
bevinden (zich)	to find
kritiek	criticism
Nederlander	Dutchman
cultuur	culture
poging	attempt
verantwoordelijk	responsible
minstens	at least
beweren	to claim
fout	error
dwingen	to force
leiding	leadership
veld	field
steunen	to support
dalen	to go down
binnenkort	shortly
vijftien	fifteen
initiatief	initiative
gevaar	danger
eventueel	potential
internet	internet
gebrek	lack
kwaliteit	quality
onderwijs	education
vertrouwen	trust
plots	sudden
product	product
beleid	policy
plegen	to commit
functie	function
eveneens	also
vijftig	fifty
ontbreken	to lack
jeugd	youth
buitenland	foreign country, abroad
termijn	term
geweld	violence
elf	eleven
zaal	hall
verdedigen	to defend
negatief	negative
vestigen	to set
onderdeel	part
aanpassen	to adjust
zwak	weak
onbekend	unknown
omstandigheid	circumstance
Belg	Belgian
koning	king
beschermen	to protect
besluit	decision
reeds	already
bevatten	to contain
praktijk	practice
totaal	total
herstellen	to recover
compleet	complete
maatschappij	society
proces	trial
verklaring	statement
brand	fire
vrijwel	almost
moord	murder
verbeteren	to improve
toenemen	to increase
maal	1) time 2) meal
oorzaak	cause
effect	a) effect b) share
principe	principle
klagen	to complain
schrijver	writer
zogenaamd	so-called
geheel	whole
tijdelijk	temporary
scherp	sharp
respect	esteem
zowat	about
streng	severe
voorwaarde	condition
kunst	art
inzetten	to bring into action
aanvankelijk	initial
leger	army
bewijs	proof
zakken	a) to drop b) to fail
bereid	prepared, ready
twijfel	doubt
vrijheid	freedom
combinatie	combination
geheel	whole
vaststellen	to determine
meerder	more
klassiek	classic
verspreiden	to spread
thema	theme
voegen	to add
gegeven	fact, data
conclusie	conclusion
veertig	forty
vlak	plane
ziekte	disease
karakter	character
overnemen	to take over
beleven	to go through
jarenlang	for years and years
afdeling	department
schijnen	to appear
behouden	to keep
advies	advice
aanval	attack
akkoord	a) agreement b) chord
journalist	journalist
gisteravond	last night
drijven	to float
verantwoordelijkheid	responsibility
zestig	sixty
materiaal	material
opleiding	training
verwachting	expectation
waarna	after which
straf	punishment
droom	dream
ideaal	ideal
rechtstreeks	direct
uitgebreid	extensive
kader	frame(work)
vlucht	a) flight b) escape
tegenstelling	contrast
seconde	second
puur	pure
pagina	page
zelden	rarely
bedanken	to thank
noodzakelijk	necessary
uitstekend	excellent
gedrag	behaviour
overleven	to survive
plaatsvinden	to take place
uiterst	extremely
vermoedelijk	supposed, suspected
voortaan	henceforth
uitmaken	a) to decide b) to break up
reizen	to travel
vechten	to fight
logisch	logical
vermoeden	to presume
creëren	to create
interview	interview
bord	plate
generatie	generation
sindsdien	since
zone	zone
huwelijk	marriage
vermoorden	to murder
commentaar	comment
computer	computer
medisch	medical
tenslotte	after all
gebeurtenis	event
gedurende	during
instelling	a) institution b) attitude
fel	fierce
papier	paper
energie	energy
weliswaar	admittedly
vermijden	to avoid
gerust	calm
val	fall
wapen	weapon
eiland	island
kern	core
verzekeren	to ensure, to assure
maatschappelijk	social
stijl	style
typisch	typical
verwijderen	to remove
debat	debate
eis	requirement
meenemen	to take
menselijk	human
verzorgen	to care for
zekerheid	certainty
eer	honour
sector	sector
restaurant	restaurant
ster	star
trots	proud
verbieden	to prohibit
getuige	witness
aanpakken	to tackle
toegang	access
zuiden	south
aangeven	to hand
waarheid	truth
effectief	effective
versterken	to strengthen
uitzondering	exception
veertien	fourteen
auteur	author
model	a) model b) model (person)
scheiden	to separate
alsnog	yet
concreet	concrete
komst	advent
buur	neighbour
gouden	gold
welkom	welcome
afhankelijk	dependent
letterlijk	literal
museum	museum
smaak	taste
snelheid	speed
individueel	individual
hiermee	herewith
elders	elsewhere
acteur	actor
uitleg	explanation
aantrekken	to put on
arts	physician
overleg	consultation
aansluiten	to connect
lossen	to unload
degene	the one, those
dom	stupid
centimeter, cm	centimetre
vertonen	to show
detail	detail
geschikt	suitable
spanning	tension
hotel	hotel
instantie	body, organization
destijds	at the time
wetenschappelijk	scientific
noorden	north
fietsen	to cycle
concert	concert
voorkeur	preference
bezit	possession
passeren	to pass
werkelijkheid	reality
fantastisch	fantastic
spannend	exciting
argument	argument
streek	a) region b) trick
moe	tired
begeleiden	to accompany, to coach
belangstelling	interest
houding	attitude
oproepen	to call
toegeven	to admit
zestien	sixteen
vangen	to catch
wens	wish
jezelf	yourself
massaal	massive
vermelden	to mention
wandelen	to walk
interesse	interest
voorstelling	performance
fase	phase
bijkomen	a) to add b) to come round
vliegtuig	plane
nood	distress
betekenis	meaning
beroemd	famous
optreden	action, performance
behandeling	treatment
ervaren	to experience
aanvaarden	to accept
kijker	viewer
verblijven	to stay
aanbod	offer
mislukken	to fail
plant	plant
traditie	tradition
verwerken	to process
verhouding	a) ratio b) affair
belasting	tax
arm	poor
specifiek	specific
zichtbaar	visible
pers	a) press (journalists) b) press
hoeveelheid	quantity
kantoor	office
zetel	seat
noch	nor
standpunt	position
dringend	urgent
gedragen (zich)	to behave
uitspreken	to pronounce
professioneel	professional
exemplaar	copy
aanwezigheid	presence
goedkeuren	to approve
toelaten	to allow
toevoegen	to add
voorbereiden	to prepare
vrouwelijk	female
kwart	quarter
draad	thread
handel	trade
opleggen	to impose
Russisch	Russian
adres	address
interesseren	to interest
zelfstandig	independent
inspanning	effort
patiënt	patient
wetenschap	science
zicht	view
heersen	a) to be b) to dominate
soldaat	soldier
motor	engine, motorcycle
verstaan	to hear, to understand
tekort	shortage
klas	class
ofwel	or
praktisch	practical
uitslag	result
waaraan	at which
uitbreiden	to expand
landelijk	national
doden	to kill
meedoen	to participate
qua	qua
achttien	eighteen
kust	coast
schitterend	brilliant
vis	fish
storten	to deposit
anderzijds	on the other hand
brug	bridge
Duitser	German
visie	vision
vandaan	from
vrede	peace
invoeren	to introduce
ongeluk	accident
jagen	to hunt
lezer	reader
opbouwen	to construct
baby	baby
handig	handy
papa	daddy
verschillen	to differ
erover	about
techniek	technique
uitgeven	to spend
verslag	report
gedeelte	section
geheim	secret
enthousiast	enthusiastic
wegen	to weigh
koop	buy
voren	forward
vluchten	to flee
constant	constant
overwegen	to consider
schatten	to estimate
vergadering	meeting
camera	camera
element	element
gevoelig	sensitive
boot	boat
plus	plus
test	test
voorspellen	to predict
nauw	tight
schuldig	guilty
combineren	to combine
noteren	to note
scheppen	a) to shovel b) to create
beperkt	limited
kwartier	quarter (of an hour)
blok	block
wisselen	to exchange
boer	farmer
grondig	thorough
aanvallen	to attack
bod	offer
pad	1) path 2) toad
ambtenaar	civil servant
gezien	considering
handelen	to act
ingaan	to enter
prins	prince
daarentegen	on the other hand
ondergaan	to undergo
ondersteunen	to support
opening	opening
pijnlijk	painful
eten	food
graad	degree
juridisch	juridical
as	a) axis b) ash
benoemen	to appoint
norm	norm
wild	wild
aantreffen	to find
afnemen	to take (away)
kritisch	critical
verzoek	request
bestellen	to order
confronteren	to confront
troep	a) army b) mess
vals	FALSE
à	to
beslag	a) batter b) fittings
volwassen	adult
meester	master
gezondheid	health
hof	court
tenzij	unless
verminderen	to reduce
blazen	to blow
vertalen	to translate
overig	remaining
vlug	quick
automatisch	automatic
correct	correct
omgaan	to handle
toepassen	to apply
afspreken	to arrange
diezelfde	the very same
meten	to measure
binden	to bind
veroveren	to conquer
verzet	resistance
gezamenlijk	joint
aantrekkelijk	attractive
drug	drug
milieu	environment
signaal	signal
ondernemen	to undertake
vak	field, profession
vreselijk	terrible
aanleggen	to build
ontwerpen	to design
stelling	a) proposition b) scaffolding
bestaan	existence
appartement	apartment
cent	cent
pensioen	pension
samenwerken	to collaborate
scherm	screen
intern	internal
park	park
opmerken	to notice
mengen	to mix
schelen	to care
kapot	broken
onderling	mutual
belachelijk	ridiculous
doorgaans	usually
ramp	disaster
vervelend	annoying
achten	to deem
inkomen	income
nadeel	disadvantage
koken	to cook
opname	shot, recording
aanspreken	a) to address b) to appeal to
klimmen	to climb
nabij	near
afleggen	to do
bescherming	protection
evenveel	same
hoogtepunt	peak, highlight
roman	novel
theater	theatre
prettig	nice
spijtig	regrettable
uitsluiten	to exclude
verwijten	to blame
omkeren	to reverse
opgeven	a) to give b) to give up
sparen	to save
tijdschrift	magazine
garanderen	to guarantee
integendeel	(on the) contrary
rit	ride
waarover	about which
zijde, zij	side
agenda	diary, agenda
beantwoorden	to answer
plat	flat
stimuleren	to stimulate
betrekking	relation
drank	drink
geheim	secret
lokken	to lure
loon	wage
ongelooflijk	incredible
kilo	kilo
pot	pot
daad	act
ei	egg
regen	rain
vermogen	a) power b) fortune
schrik	fright
storen	to disturb
ondervinden	to experience
trachten	to attempt
uitzending	broadcast
vanzelf	automatically
haven	harbour
professor	professor
aangenaam	pleasant
bestrijden	to dispute
katholiek	Catholic
verbazen	to surprise
waaruit	from which
daaraan	thereto
koningin	queen
oefenen	to practise, to exercise
onderscheiden	to distinguish
opkomen	a) to come up b) to fight for
pikken	a) to pinch b) to tolerate
vastleggen	to fix
fabriek	factory
uitsluitend	exclusively
slikken	to swallow
vierkant	square
krachtig	powerful
theorie	theory
terugkeer	return
dikwijls	often
innemen	a) to swallow b) to take up
leraar	teacher
tempo	pace
toeval	coincidence
streep	stripe
geboorte	birth
kortom	in short
wil	will
koppelen	to couple
paal	pole
structuur	structure
toerist	tourist
uitvoering	implementation
inzicht	insight
kat	cat
tweemaal	twice
verplaatsen	to move
echtgenote	wife
letter	letter
schaal	a) dish b) scale
afwachten	to wait
bibliotheek	library
althans	at least
huren	to rent
kamp	camp
voedsel	food
zwanger	pregnant
arbeider	worker
excuus	excuse
midden	in the middle of
raden	to guess
negeren	to ignore
ophalen	a) to collect b) to pull up
accepteren	to accept
aspect	aspect
bodem	bottom
stom	stupid
aard	nature
concentreren (zich)	to concentrate
landschap	landscape
verwerven	to acquire
wekelijks	weekly
literatuur	literature
cadeau	gift
lengte	length
document	document
onzin	nonsense
temperatuur	temperature
terechtkomen	to land
bezwaar	objection
christelijk	Christian
nogmaals	again
vervoer	transport
onderweg	on the way
strand	beach
zwemmen	to swim
gewicht	weight
toestemming	permission
vernietigen	to destroy
evenwicht	balance
stroom	a) flow b) stream c) electricity
zeventien	seventeen
kring	circle
toepassing	application
vijand	enemy
staatssecretaris	Secretary of State
gunstig	favourable
reclame	advertisement
doek	cloth
oordeel	judgement
pand	property
vlag	flag
toestel	appliance
gedicht	poem
ingang	entrance
olie	oil
schilderij	painting
college	lecture
plein	square
datum	date
emotioneel	emotional
strijden	to fight
uitzonderlijk	exceptional
verlenen	to grant
vers	fresh
duur	duration
goud	gold
bovenop	on top
trappen	a) to kick b) to cycle
hierover	about this
bezetten	a) to occupy b) to set
boel	lot
fris	fresh
staken	a) to cease b) to strike c) to tie
verrichten	to perform
gunnen	to grant
methode	method
vergroten	to enlarge
status	status
massa	mass
random	all round
ton	a) barrel b) 1000 kilo c) 100,000 euro
e-mail	e-mail
functioneren	to function
nuttig	useful
tocht	tour
aandoen	a) to cause b) to put on
realiteit	reality
aanvullen	to complement
dodelijk	lethal
verstand	head
bevallen	a) to please b) to give birth
uiten	to express
begeleiding	supervision
gedeeltelijk	partial
registreren	to register
afbreken	to break off/down
informeren	to inform
permanent	permanent
daartoe	~ to it
agressief	aggressive
heus	real
lenen	a) to borrow b) to lend
onschuldig	innocent
opvangen	a) to take care of b) to catch
vervullen	to fulfil
zenden	to send
afronden	a) to round up b) to finish
familielid	relative
namiddag	(late) afternoon
seksueel	sexual
bak	container
ondertekenen	to sign
aanwijzen	to show to
beest	beast
verzetten	to move
bakken	to bake
verkeren	to be
hallo	hello
overblijven	a) to remain b) to stay behind
voornaam	a) prominent b) main
bijten	to bite
minimaal	minimum
totdat	until
vernemen	to learn
held	hero
meid	girl
daaruit	from it
regeling	regulation
ring	ring
terugvinden	to find again
verbetering	improvement
vervolg	continuation, sequel
humor	humour
omvatten	to include
vasthouden	to hold
onderhouden	to maintain
avontuur	adventure
beheersen	to command
vanzelfsprekend	obvious
varen	to sail
constateren	to ascertain
inrichten	to furnish
louter	mere
verderop	further down
begraven	to bury
gerucht	rumour
machine	machine
symbool	symbol
bocht	curve, bend
instrument	instrument
spontaan	spontaneous
cursus	course
middelbaar	a) middle b) secondary
bevoegdheid	authority
exact	exact
maximum	maximum
seks	sex
studio	studio
gans	whole
invullen	to fill in
bende	gang
gigantisch	gigantic
mannelijk	male
communicatie	communication
lelijk	ugly
afkomst	origin
bestuderen	to study
hoogleraar	professor
gevecht	fight
identiteit	identity
overdag	by day
passagier	passenger
schakelen	to switch
stemming	a) vote b) mood
aanvragen	to request, to apply for
duidelijkheid	clearness
inspireren	to inspire
instellen	to set
alcohol	alcohol
creatief	creative
hetgeen	that which, what
gsm	mobile phone
rondlopen	to walk about
aanbrengen	to apply
langdurig	prolonged
afvragen	to wonder
beoordelen	to judge
trouw	faithful
afschaffen	to abolish
intensief	intensive
personage	person, character
verlagen	to lower
wijden	to devote
zwembad	swimming pool
ingewikkeld	complicated
overdreven	overdone
pauze	break, half-time
verstandig	wise
vertrouwen	to trust
afleiden	a) to distract b) to deduce
gas	gas
leerkracht	teacher
opeens	suddenly
paniek	panic
verzinnen	to invent
doelstelling	goal
strikt	strict
zodanig	such
bol	sphere
hechten	to attach
kleuren	to colour
tekening	drawing
bom	bomb
boord	collar
uitkijken	to watch
zeldzaam	rare
alleszins	in every way
bedreiging	threat
kleren	clothes
medicijn	drug, medicine
opzet	a) planning, design b) intention
uitbrengen	to publish, to release
collectie	collection
wetgeving	legislation
kleding	clothing
joods	Jewish
kanaal	channel
klimaat	climate
regeren	to reign, to govern
terras	terrace
aanzien	respect
bijeenkomst	meeting
doorbreken	to break through
zuiver	pure
besparen	to save
keuren	to test, to taste
onthouden	to remember
supermarkt	supermarket
aanduiden	to indicate
tent	tent
vermoeden	presumption
evenals	as well as
Grieks	Greek
ingrijpen	to intervene
kasteel	castle
ruil	exchange
bereiden	to prepare
braaf	good
neerleggen	to put down
berekenen	to calculate
moreel	moral
saai	boring