tegenkomen	to encounter
verdrag	treaty
aanwijzing	sign, indication
echtgenoot	husband
suggereren	to suggest
uitwerken	to elaborate
vrucht	fruit
allereerst	first
ruimen	to clean up
voorganger	predecessor
burgerlijk	civil
wapenen (zich)	to arm
adviseren	to advise
boeien	to entertain
Duits	German
gebruikelijk	usual
monument	monument
namens	on behalf of
opsluiten	to lock up
voeden	to feed
gelijk	right
machtig	powerful
misdaad	crime
opduiken	to emerge
aanvraag	application
architect	architect
benaderen	to approach
overtuiging	conviction
scheiding	separation, divorce
bezighouden	to occupy
vleugel	wing
falen	to fail
medaille	medal
omvang	size
straffen	to punish
verblijf	stay
muzikant	musician
vereisen	to require
voorheen	before
wezen	being
blank	white, blank
opvatting	view, opinion
keihard	hard
regenen	to rain
waarderen	to appreciate
fractie	a) ~ party, group b) fraction
gemeenschappelijk	common
generaal	general
ongelukkig	unhappy
opzoeken	to visit
vrijwillig	voluntary
bijeen	together
haat	hate
kip	chicken
literair	literary
aanstellen	to appoint
voorwerp	object
enerzijds	on the one hand
garantie	guarantee
talloos	countless
wandeling	walk
toren	tower
bestemming	destination
openlijk	open, public
uitgever	publisher
zitting	a) seat b) session
armoede	poverty
opmaken	to conclude
wennen	to get used to
gering	slight, little
invoering	introduction
onderscheid	distinction
opbrengen	to yield
bad	bath
prioriteit	priority
protesteren	to protest
allicht	probably
handhaven	to maintain
mail	e-mail
route	route
huisarts	general practitioner
ikzelf	(I) myself
jood	Jew
pc	personal computer
talrijk	numerous
toneel	stage
vies	dirty
zelfmoord	suicide
kassa	cash desk
nadruk	emphasis
pech	bad luck
achterhalen	a) to retrieve, to recover b) to overtake
doorheen	through
garage	garage
bedienen	a) to serve b) to operate
formeel	formal
landbouw	agriculture
loopbaan	career
nader	further
neef	nephew, cousin
toezicht	supervision
verloop	course
veronderstellen	to suppose
geleidelijk	gradual
inhouden	a) to deduct b) to imply
omzetten	to convert
afzien	a) to forgo b) to have a hard time
begaan	to commit
behulp	help
leed	sorrow
opgroeien	to grow up
schoppen	to kick
vertaling	translation
afwijzen	to reject
neerzetten	to put down
proeven	to taste
uiterlijk	appearance
vlakbij	close
zozeer	so much
apparaat	device
duiden	to point at
geliefd	beloved
hooguit	at most
uitgeverij	publisher
voordoen	a) to occur b) to show c) to put on
dialoog	dialogue
mededeling	announcement
overbodig	superfluous
uitroepen	to exclaim, to proclaim
buitenlander	foreigner
aandringen	to insist
context	context
minister-president	prime minister
ontvangst	reception
opvoeding	upbringing
reserveren	to reserve
vervelen (zich)	to be bored
heet	hot
video	video
noodzaak	need
presentatie	presentation
prinses	princess
aangaan	to start
formuleren	to formulate
grof	coarse, gross
uitoefenen	to exercise
enquête	survey
flauw	weak
romantisch	romantic
trui	sweater
poort	gate
uitvallen	to drop/fall out
elektrisch	electric
omringen (zich)	to surround
pop	doll
voortzetten	to continue
vooruitgang	progress
examen	examination
failliet	bankrupt
meewerken	to contribute
melk	milk
actueel	current
eigenschap	property, characteristic
meebrengen	to bring
nut	use
uitgroeien	to grow
vergissen (zich)	to be mistaken
verplichting	obligation
dans	dance
geduld	patience
lichamelijk	physical
verwarren	to confound
achteraan	behind
paren	to mate
perspectief	perspective
uitdelen	to distribute
ultiem	ultimate
inzien	to see
opheffen	a) to lift b) to abolish
liefhebber	lover
afspelen (zich)	to happen
feitelijk	factual
kanker	cancer
pas	a) step b) pass(port)
uitbreken	to break out
volstrekt	absolutely
aanzetten	to encourage
groente	vegetable
koper	1) buyer 2) copper
motief	motive
opleiden	to train
revolutie	revolution
beëindigen	to terminate
kwaad	evil
schilder	painter
verstoppen	to hide
voorop	ahead
afzetten	a) to drop off b) to cheat c) to turn off
belasten	a) to tax b) to overload
diploma	diploma
herhaling	repetition
onderuit	~ sprawled
samenstellen	to compose, to put together
schetsen	to sketch
verhinderen	to prevent
bitter	bitter
boerderij	farm
officier	officer
overgaan	a) to move up b) to pass
ertoe	to
missie	mission
vervallen	to disappear
buitengewoon	exceptional, extraordinary
dank	thanks
hoofdstuk	chapter
opgaan	to merge
terugtrekken	to withdraw
balen	to be fed up with
desnoods	if necessary
kwetsbaar	vulnerable
onzekerheid	uncertainty
proef	test
uitkering	payment, benefit
wiel	wheel
individu	individual
stress	stress
groots	grand, ambitious
lezing	lecture
stilstaan	to stop
toilet	toilet
verzameling	collection
vorderen	a) to claim b) to progress
experiment	experiment
gezondheidszorg	health care
opvoeren	a) to increase b) to stage
pakket	packet
pil	pill
ritme	rhythm
uitschakelen	to eliminate
vergoeding	compensation
pen	pen
reiziger	traveller
salaris	salary
kwetsen	to hurt
meer	more
fundamenteel	fundamental
geestelijk	mental
oma	grandma
storm	storm
vanochtend	this morning
verzekering	insurance
appel	apple
bereikbaar	reachable
chaos	chaos
gezag	authority
onderschatten	to underestimate
zielig	pathetic
desondanks	nevertheless
plicht	duty
betaling	payment
plukken	to pick
vervoeren	to transport
beïnvloeden	to influence
doorlopen	a) to keep on walking b) to go through
duurzaam	durable
fruit	fruit
hobby	hobby
kapitein	captain
luxe	luxury
uitrusten	a) to equip b) to rest
werkzaamheden	activities
wortel	a) carrot b) root
intrekken	a) to retract b) to withdraw
paars	purple
bizar	bizarre
citeren	to quote
voorafgaan	to precede
aansluiting	connection
betrouwbaar	reliable
net	net
verstoren	to disturb
waarschuwing	warning
arbeid	labour
bestemmen	to intend
frustratie	frustration
tegenhouden	to stop
administratie	administration
evolueren	to evolve
nadrukkelijk	emphatic
vet	fat
vloeien	to flow
duivel	devil
herkenbaar	recognizable
verf	paint
financieren	to finance
suggestie	suggestion
greep	grab
tarief	rate
uitkomst	result
kleinkind	grandchild
ontdekking	discovery
vergen	to require
bezetting	a) occupation b) cast
leugen	lie
psychologisch	psychological
jarig	celebrating a birthday
nagenoeg	almost
waardevol	valuable
kelder	basement
optimaal	optimal
opvoeden	to raise
accent	a) accent b) emphasis
doorgeven	to pass on
formule	formula
handicap	handicap
jacht	a) hunt(ing) b) yacht
laag	layer
moordenaar	murderer, killer
passie	passion
som	sum
getal	number
klikken	to click
naarmate	as
onderbrengen	to accommodate, to lodge
opvang	care
trek	appetite
inhoudelijk	substantive, concerning content
onthullen	to reveal
overgang	transition
voorziening	facility
snelweg	motorway
discipline	discipline
particulier	private
slopen	to demolish
uitrekenen	to calculate
enkel	ankle
filosofie	philosophy
oranje	orange
part	part
steevast	invariably
verschijnsel	phenomenon
verstrekken	to provide
bevoegd	competent
smaken	to taste
verbranden	to burn
voorgaan	to let go first
illusie	illusion
neiging	tendency
stal	stable
verlichting	light(ing)
wijken	to disappear
hoofdredacteur	editor-in-chief
volhouden	to maintain
wacht	1) watch 2) guard
zakelijk	business
afzonderlijk	separate
ondersteuning	support
toespraak	speech
waarnemen	to observe
goedkeuring	approval
installeren	to install
tijdstip	(point of/in) time
analyseren	to analyse
afwijken	to deviate
gids	guide
laden	to load
opruimen	to tidy up
opstand	rebellion
uitgangspunt	starting point
vocht	1) moisture 2) liquid
bevel	command
bloeien	to bloom
docent	teacher, lecturer
dreiging	threat
gedoe	hassle
lente	spring
minimum	minimum
beloning	reward
compenseren	to compensate
datzelfde	the same
dichter	poet
noot	a) note b) nut
paleis	palace
priester	priest
vluchteling	refugee
bladzijde	page
grootte	size
kaas	cheese
kleuter	infant
mentaliteit	mentality
ondergronds	underground
onwaarschijnlijk	unlikely
uitnodiging	invitation
verwijt	reproach
weerstand	resistance
afmaken	to finish
afval	waste
huwen	to marry
omtrent	about
verwerpen	to reject
interpretatie	interpretation
lading	load
redenering	reasoning
stoer	tough
tram	tram
versieren	to decorate
buurman	neighbour
intelligent	intelligent
kapitaal	capital
lawaai	noise
objectief	objective
rel	riot
zonde	sin
affaire	affair
begrijpelijk	understandable, comprehensible
biologisch	biological
communistisch	communist
dagblad	newspaper
flat	flat
kogel	bullet
schande	shame, disgrace
frustreren	to frustrate
opletten	to pay attention
persoonlijkheid	personality
traject	route
bioscoop	cinema
feestdag	holiday
integreren	to integrate
recept	recipe
rijp	ripe
ronduit	outright, simply
tijdig	timely
archief	archive
gitaar	guitar
put	well
rond	round
concentratie	concentration
dagen	a) to summon b) to dawn
koor	choir
neigen	to incline
oefening	exercise
schitteren	to shine
uithalen	a) to lash out b) to be up to
aanvoeren	to supply, to bring
glazen	glass
progressief	progressive
uitpakken	a) to unpack b) to turn out
vreemdeling	stranger
evengoed	as well
kweken	to cultivate, to grow
middernacht	midnight
munt	coin
opslaan	to store
uitdrukken	to stub out
afhangen	to depend
filmen	to film
overleggen	to consult
versnellen	to accelerate
verwoesten	to destroy
aantasten	to affect
bewerken	to work
doorvoeren	to carry out
feliciteren	to congratulate
fier	proud
handeling	action
weleens	sometimes, ever
zuur	acid
ambassadeur	ambassador
neutraal	neutral
nuchter	a) empty, sober b) plain
vooraan	in front
fataal	fatal
intellectueel	intellectual
maandelijks	monthly
mode	fashion
verkondigen	to proclaim, to put forward
woonplaats	residence
beslist	decisive, resolute
bovenaan	at the top
dijk	dike
gieten	to pour
misverstand	misunderstanding
omkomen	to die
trouw	faith(fulness)
afvoeren	to transport
eng	scary
ontploffen	to explode
rang	rank
richtlijn	guideline
ruilen	to exchange
straf	hard
deugd	virtue
discussiëren	to discuss
essentieel	essential
evident	evident
genezen	to cure
inrichting	design
jaloers	jealous
motto	motto
naïef	naive
nicht	niece, cousin
plezant	amusing
gruwelijk	horrible
kabel	cable
schaap	sheep
tienduizend	ten thousand
zolang	as long as
aanraden	to recommend
bui	shower, rain
medewerking	collaboration
opinie	opinion
piano	piano
afwisselen	to alternate
financiering	financing
merendeel	most, majority
receptie	reception
sedert	since
staking	strike
verschaffen	to provide
versturen	to send
voltooien	to complete
absurd	absurd
communiceren	to communicate
levenslang	lifelong
signaleren	to signal, to observe
vet	fat
zogezegd	so to speak
afgeven	to deliver
bijnaam	nickname
verbouwen	a) to renovate b) to cultivate
bedriegen	to cheat
code	code
herfst	autumn
meespelen	to take part, to play
orkest	orchestra
uiting	expression
verdienste	merit
bisschop	bishop
onnodig	unnecessary
profiel	profile
toestaan	to allow
transport	transport
beledigen	to offend
compromis	compromise
motivatie	motivation
pint	pint, (glass of) beer
reëel	real
zinloos	meaningless
zout	salt
aanstaand	next, this
buis	tube
deftig	distinguished
fascineren	to fascinate
inval	raid
opdoen	to gain
passage	passage
schooljaar	school year
weekblad	weekly magazine
filosoof	philosopher
industrieel	industrial
ingenieur	engineer
voorraad	stock
muis	mouse
baat	benefit
bakker	baker
front	front
logica	logic
overeenkomen	to correspond, to match
voorschrijven	to prescribe
aanslaan	a) to be successful b) to tax
beogen	to aim
betwijfelen	to doubt
onderdak	accommodation, shelter
staf	a) staff (object) b) staff (people)
telefonisch	telephonic
verschuiven	to move
zilver	silver
bespreking	discussion
fuif	party
illustreren	to illustrate
nagaan	to check
raadplegen	to consult
soepel	flexible, smooth
vrijkomen	a) to be set free b) to be released
zonnig	sunny
ambassade	embassy
bevriend	friendly
doodschieten	to shoot (dead)
homo	gay
patroon	pattern
planeet	planet
toewijzen	to assign
uitzetten	a) to turn off b) to deport, to throw out
afkomen	to come down
afleveren	to deliver
alvorens	before
leeuw	lion
systematisch	systematic
verdrijven	to expel
verwennen	to pamper
waardering	appreciation
alleenstaand	single
eenmalig	one-off
eenzelfde	same
haken	to catch, to hook
onderaan	at the bottom
terugbrengen	to return
uitbouwen	to extend
vondst	find
weghalen	to remove
uittrekken	to take off
dienstverlening	service(s)
immens	immense
korting	discount
stroming	current, movement
verkrachten	to rape
vliegveld	airport
beletten	to prevent
benadering	approximation, approach
consequentie	consequence
fungeren	to function
helling	slope
politieagent	police officer
ras	race, breed
relevant	relevant
stempel	stamp
uitvinden	to invent
werkgroep	working group
afstuderen	to graduate
bekleden	to occupy
kroon	crown
schrijfster	writer, authoress
tegenvallen	to disappoint
toer	tour
vergezellen	to accompany
verkennen	to explore
achterkant	back
bekomen	to recover
expliciet	explicit
minst	least
opera	opera
service	service
middeleeuws	medieval
object	object
overschot	surplus
psychisch	psychological
rijkdom	wealth
suiker	sugar
tegendeel	opposite
vergoeden	to reimburse
aanbieding	offer
ban	ban
bijhouden	to keep (up)
depressie	depression
graven	to dig
marge	margin
onszelf	ourselves
opa	grandpa
virus	virus
biografie	biography
overdragen	to pass on, to transfer
schandaal	scandal
advertentie	advertisement
bewaken	to guard
bundel	edited volume
herkomst	origin
klooster	monastery
peil	level
stadium	stage
berekening	calculation
continu	continuous
monster	a) monster b) sample
paspoort	passport
tunnel	tunnel
tweetal	two
lekken	to leak
onbegrijpelijk	incomprehensible
onderwerpen	to subject
pakweg	roughly
subtiel	subtle
triest	sad
verzoeken	to request
waardig	worthy
Bijbel	bible
bijwonen	to attend
geldig	valid
meevallen	to turn out not too bad
pond	pound
sloot	ditch
verwaarlozen	to neglect
aanvang	commencement
cliché	cliché
ophangen	to hang
orgaan	organ
rechtvaardigen	to justify
tropisch	tropical
bon	a) coupon b) ticket
citaat	quote
comfortabel	comfortable
continent	continent
formaat	format
identificeren	to identify
indertijd	at the time
kunstmatig	artificial
landgenoot	countryman
taboe	taboo
theoretisch	theoretical
verhuren	to let
welvaart	prosperity
willekeurig	arbitrary
herhaaldelijk	repeatedly
pensioneren	to retire
wederzijds	mutual
wegnemen	to take away
academie	academy
gehandicapt	handicapped
hekel	dislike
ietwat	somewhat
ongewenst	unwanted, undesirable
overhouden	to have left
pastoor	pastor
schriftelijk	written
teleurstelling	disappointment
agressie	aggression
andersom	vice versa
opblazen	to blow
platteland	countryside
rot	a) rotten b) rotten, awful
universitair	university
verwelkomen	to welcome
wraak	revenge
aankunnen	to manage
aap	monkey
actualiteit	current event
beleggen	a) to convene b) to invest
besmetten	to infect
bevelen	to order, to command
bewonen	to live in, to inhabit
cool	cool
diplomatiek	diplomatic
geregeld	regularly
huur	rent
sympathiek	sympathetic
toneelstuk	play
trakteren	to treat
variatie	variation
wc	toilet
wederom	again
werkdag	working day
afgaan	a) to fail b) to go off
gehoor	hearing
invallen	to stand in
mits	provided that
tijdperk	era
T-shirt	T-shirt
allesbehalve	anything but
consequent	consistent
politieman	policeman
software	software
uitsterven	to die (out)
allerhande	all kinds of
bevriezen	to freeze
fragment	fragment
sympathie	sympathy
vooroordeel	prejudice
begeleider	supervisor
hogeschool	college
integraal	integral
lof	praise
opbouw	construction
oversteken	to cross
problematiek	problems
uitvoerig	detailed
verkoper	seller
waartoe	to which
aanmoedigen	to encourage
achterin	in the back
bestand	a) file b) truce
ongeacht	regardless
ontlenen	to derive
overstappen	to change over
vijver	pond
voorval	incident
weduwe	widow
wegleggen	to put away
aanrichten	to cause
bijstaan	to assist
overwinnen	to overcome
schijf	a) slice b) disk
vorst	1) monarch 2) frost
bevestiging	confirmation
fatsoenlijk	decent
geruim	considerable
kledij	clothing
planten	to plant
proper	tidy, clean
restaureren	to restore
zelfvertrouwen	self-confidence
hopeloos	hopeless
tank	a) (fuel) tank b) tank (army vehicle)
uiterlijk	external
verleiden	to seduce
vuurwerk	firework
zuinig	frugal
afstaan	to give up
architectuur	architecture
evaluatie	evaluation
folder	leaflet
gunst	favour
kermis	fair
leer	1) leather 2) doctrine
sprang	jump
varken	pig
verwoorden	to articulate
essentie	essence
kar	cart
kijk	look
overeenstemming	agreement
overweging	consideration
psycholoog	psychologist
spot	a) spotlight b) ridicule
winkelen	to shop
bel	bell
keten	chain
oppassen	to babysit
pompen	to pump
schenden	to harm
stop	stop
vraagteken	question mark
corrigeren	to correct
echo	echo
geschrift	writing
inlichting	information
menu	menu
taart	cake
aanschaffen	to purchase
ethisch	ethical
kopie	copy
levendig	lively
vaderland	(native) country
standaard	standard
baren	to bear
contrast	contrast
ferm	firm
genetisch	genetic
globaal	rough
pesten	to bully
privacy	privacy
uitlopen	a) to sprout b) to lead to
dosis	dose
krap	tight
overheersen	to dominate
truc	trick
vaardigheid	skill
associëren	to associate
bestraffen	to punish
deal	deal
erfenis	heritage, inheritance
invulling	interpretation, filling-in
psychiater	psychiatrist
speelgoed	toys
zeil	sail
apparatuur	equipment
inbouwen	to build in
isoleren	to isolate
metro	metro
overtreffen	to surpass
piloot	pilot
redding	rescue
schema	scheme
toekomen	to get round to
uitverkopen	to sell out
vacature	vacancy
afkeuren	to disapprove
dal	valley
experimenteren	to experiment
idioot	idiot
inschatten	to assess, to estimate
introductie	introduction
kerst	Christmas
meer	lake
overdrijven	to exaggerate
rauw	raw
slordig	untidy, sloppy
verleden	past, last
verlof	leave
zaaien	to sow
beschaving	civilization
demonstreren	a) to show b) to protest
dirigent	conductor
tweeling	twins
veelvuldig	frequent
woestijn	desert
zinvol	meaningful
aanmelden (zich)	to sign up
bruikbaar	useful
camping	camp site
compliment	compliment
dopen	to baptize
kappen	to cut (down)
moedig	brave
opknappen	a) to do up, to restore b) to recover
vlakte	plain
bewering	assertion
erna	after (it)
interviewen	to interview
kalender	calendar
ongelijk	unequal
sprookje	fairy tale
uitstap, uitstapje	trip
buurvrouw	neighbour, woman next door
chocolade	chocolate
hoofddoek	headscarf
inhalen	to overtake
kleintje	little one
mythe	myth
schandalig	scandalous
verouderen	to age
volgorde	order
bevrijding	liberation
inspecteur	inspector
manipuleren	to manipulate
opgave	task
vissen	to fish
ideaal	ideal
ironisch	ironic
kopiëren	to copy
opeisen	to claim
strip	cartoon
troon	throne
uitermate	extremely
vergaderen	to meet
vermits	since
wegvallen	to be lost
bestelling	order
boeiend	fascinating
bronzen	bronze
diagnose	diagnosis
driekwart	three-quarter
lief	beloved
materie	matter
ontnemen	to deprive
afstemmen	to tune, to adjust
helikopter	helicopter
indelen	to classify, to group
inleiding	introduction
lek	leaky, flat
metaal	metal
uitkiezen	to pick
afbeelden	to depict
afdoen	a) to take off b) to dismiss
afrekenen	a) to settle the bill b) to judge (on)
benzine	petrol
bezien	to see
bont	(multi)coloured
conferentie	conference
juf	(female) teacher
medium	medium
pijl	arrow
pittig	spicy
planning	plan(ning)
razend	a) furious b) very
allerlaatst	very last
explosie	explosion
portie	serving
slang	a) snake b) hose
toets	key
verpakking	packing
hoeverre	to what extent
journaal	news
kapel	chapel
paradijs	paradise
plak	slice
revolutionair	revolutionary
voorin	in (the) front
afhalen	to pick up, to collect
fanatiek	fanatic
hakken	to cut/hew (out)
luik	a) shutter b) part
stammen	to date
afwijking	deviation
checken	to check
drang	urge
duister	dark
regelmaat	regularity
verantwoording	responsibility
volume	volume
boter	butter
identiek	identical
onnozel	silly
pogen	to attempt
profeet	prophet
prooi	prey
voornemen	to plan
wantrouwen	distrust
wetsvoorstel	bill
wijsheid	wisdom
zodoende	consequently
landen	to land
mist	fog
nachtmerrie	nightmare
ondergang	(down)fall, destruction
rat	rat
bereik	reach
beschouwing	consideration, view
betoog	argument, plea
binnenland	inland
buitenkant	outside
chic	chic
eend	duck
gokken	to gamble
instorten	to collapse
order	order
rede	speech
regelrecht	straight
uitdrukkelijk	explicit
beer	bear
komisch	comic
redeneren	to reason
verwarming	heating
woeden	to rage
communist	communist
daaronder	thereunder
doortrekken	a) to extend b) to flush
harmonie	harmony
puber	adolescent
rijst	rice
spreker	speaker
kantine	canteen
molen	mill
zijkant	side
kas	a) greenhouse b) cash
kerkelijk	ecclesiastical, church
verslaafd	addicted
breedte	width
erdoor	through it
koelkast	refrigerator
kwijtraken	to lose
meegeven	to give
opeten	to eat
sporten	to play sport, to exercise
verbond	treaty, covenant
verpakken	to wrap up
voortkomen	to result
weerhouden	to withhold
beton	concrete
box	speaker
eergisteren	day before yesterday
heden	today
pap	porridge
wezenlijk	substantial
alsmaar	ever
giftig	toxic
hieruit	from this
boren	to drill
doorstaan	to endure
gelovig	faithful
kruid	herb
moraal	moral
oftewel	i.e.
beslaan	to cover
jegens	towards
meekrijgen	to get, to receive
steil	steep
strook	strip
blijk	token
omgang	contact
opdringen	to impose
shit	shit
uitwerking	effect
brein	brain
friet	French fries, chips
microfoon	microphone
opvatten	to take
tegenaan	against it, for it
tegenovergesteld	opposite
lui	lazy
rolstoel	wheelchair
verwarmen	to warm, to heat
abstract	abstract
ridder	knight
toetsen	to test
vastzitten	to get stuck
afvallen	a) to fall down b) to lose weight
betrekkelijk	relatively
etiket	label
inzitten	to sit in, to contain
overlaten	to leave
permitteren	to afford
vanwaar	from where, why
weggooien	to throw away
brievenbus	letterbox
formulier	form
goed	good
kostuum	suit
onbelangrijk	unimportant
vlinder	butterfly
zegen	blessing
samenvatten	to summarize
daarbuiten	outside
standbeeld	statue
taalgebruik	language usage
duw	push
oppikken	to pick up
prent	print
zagen	to saw
hoelang	how long
ijzer	iron
koorts	fever
poster	poster
wolf	wolf
worst	sausage
christen	Christian
nota	note, bill
snoep	sweets
zeilen	to sail
bezitting	possession
onderkant	underside
viool	violin
ontspanning	relaxation
piek	peak
portemonnee	wallet
slijten	to wear (out)
veronderstelling	hypothesis
vers	verse
solliciteren	to apply
kathedraal	cathedral
saus	sauce
babbelen	to chat
knal	bang
huiswerk	homework
deugen	to be good
drieduizend	three thousand
kapper	hairdresser
omslag	1) cover 2) change
onvoorstelbaar	unimaginable
terzijde	aside
datgene	what
naar	nasty
oven	oven
plassen	to have a pee
pardon	pardon
woordenboek	dictionary
tomaat	tomato
aansteken	to light
goddelijk	divine
nimmer	never
samenwonen	to live together, to cohabit
honderdduizend	hundred thousand
map	folder
uzelf	yourself
achterop	on the back
uithangen	to hang out
verschieten	to go pale
vijfduizend	five thousand
tandarts	dentist
zoal	what (kind of things)
eer	before
kap	hood
onderwijzer	teacher
kot	student accommodation
akelig	nasty
hol	hole
vermaken	to entertain
ontbijten	to have breakfast
überhaupt	anyway, at all
telefoneren	to phone
stenen	stone